. . . . B . . . . . 
. . . B B . . . B B 
- - B 2 1 0 9 8 7 6 
- - B B B B B B B 5 
- - B - - - B B - 4 
- - B - - B B 2 3 . 
- - - - - - 0 1 B . 
. - - - - - S B . . 
. . B B - - B . . . 
. . . B - - . . . . 
