B . B B B B . B B B B B B B . 
B . . . . B . . B B B - ~ B . 
B B B B . B B . B B B ~ ~ B . 
B B B B . . . . B B ~ ~ B B . 
B . . . . B B B B B S B B B . 
. . B B B B B B B B 0 B ~ B . 
B . B . . . B B B B 1 B ~ B . 
B . . . B . . - ~ ~ 2 ~ ~ B E 
B . B . . . B B B B 3 B B B 1 
. . B B B . B B B B 4 B 8 9 0 
B . B B B . B B B B 5 6 7 B B 
B . B B B . B B B B B B B B B 
B . B B B B B B B B B B B B B 
B . . . . . . . . . B B B B B 
B B B B B B B B B . B B B B B 
