. - - - - - - - - - - - - - . 
- - 5 4 3 2 1 0 9 8 7 6 5 - - 
- 6 - B B ~ ~ ~ ~ ~ B B 4 ~ - 
- E - B B B ~ ~ ~ B B B 3 ~ ~ 
. . . . B B - - - B B ~ 2 ~ ~ 
. . . . . . B B B ~ ~ 1 ~ ~ ~ 
. . . . . . B B B ~ ~ 0 ~ ~ ~ 
B B B B B B B B B ~ ~ 9 ~ ~ ~ 
~ ~ ~ ~ ~ 0 S B ~ ~ ~ 8 ~ ~ ~ 
~ ~ ~ ~ 1 ~ ~ B ~ ~ ~ 7 ~ ~ ~ 
~ ~ ~ 2 ~ B B B B B ~ 6 ~ ~ ~ 
~ ~ ~ 3 ~ B ~ ~ ~ B ~ 5 ~ ~ ~ 
~ ~ ~ 4 B B ~ ~ ~ B B 4 ~ ~ ~ 
~ ~ ~ 5 ~ B ~ ~ ~ B ~ 3 ~ ~ - 
~ ~ ~ ~ 6 7 8 9 0 1 2 ~ ~ ~ - 
