~ ~ ~ ~ ~ ~ ~ ~ ~ ~ ~ ~ ~ ~ - 
~ ~ 3 4 5 6 7 8 9 0 1 2 3 ~ ~ 
~ ~ 2 B B ~ ~ ~ ~ ~ B B 4 ~ ~ 
~ ~ 1 B B B ~ ~ ~ B B B 5 ~ ~ 
~ ~ 0 ~ B B ~ ~ ~ B B ~ 6 ~ ~ 
~ S ~ ~ ~ ~ B B B ~ ~ 7 ~ ~ ~ 
~ ~ ~ ~ ~ ~ B B B ~ ~ 8 ~ ~ ~ 
B B B B B B B B B ~ ~ 9 ~ ~ ~ 
. . . . . . . B ~ ~ ~ 0 ~ ~ ~ 
. . . . . . . B ~ ~ ~ 1 ~ ~ ~ 
. . . . . B B B B B ~ 2 ~ ~ ~ 
. - E - . B ~ ~ - B ~ 3 ~ ~ ~ 
. - 4 - B B ~ ~ - B B 4 ~ ~ - 
. - - 3 - B ~ ~ - B ~ 5 ~ - - 
. . - - 2 1 0 9 8 7 6 - - - . 
