. . . . . . . . . . . . . . . 
. . . . . . . . . . . . - - . 
. . . B B . . . . . B B ~ - - 
. . . B B B . . . B B B ~ ~ - 
. . . . B B . . . B B ~ ~ ~ ~ 
. . . . . . B B B ~ ~ ~ S ~ ~ 
. . . . . . B B B ~ ~ 0 ~ ~ ~ 
B B B B B B B B B ~ ~ 1 ~ ~ ~ 
. . . . . . . B ~ ~ ~ 2 ~ ~ ~ 
. . . . . . . B ~ ~ ~ 3 ~ ~ ~ 
. - E - . B B B B B ~ 4 ~ ~ ~ 
. - 7 - . B ~ ~ - B ~ 5 ~ ~ ~ 
. - 6 - B B ~ ~ - B B 6 ~ ~ - 
. - - 5 - B ~ ~ - B ~ 7 ~ - - 
. . - - 4 3 2 1 0 9 8 - - - . 
