. B B . . . . . . . . . . . . . . . . . . . . . . . . . . . . . . . . . . . . . . . . . . . . . . . . . . . . . . . . . . . . . . . . . . . . . . . . . . . . . 
. B B . . . . . . . . . . . . . . . . . . . . . . . . . . . . . . . . . . . . . . . . . . . . . . . . . . . . . . . . . . . . . . . . . . . . . . . . . . . . . 
. B B . . . . . . . . . . . . . . . . . . . . . . . . . . . . . . . . . . . . . . . . . . . . . . . . . . . . . . . . . . . . . . . . . . . . . . . . . . . . . 
. B B . . . . . . . . . . . . . . . . . . B B B B B B B B B B B B B . . . . . . . . . . . . . . . . . . . . . . . . . . . . . . . . . . . . . . . . . . . . . . 
. B B . . . . . . . . . . . . . . . . . . B B B B B B B B B B B B B . . . . . . . . . . . . . . . . . . . . . . . . . . . . . . . . . . . . . . . . . . . . . . 
. . . . . . . . . . . . . . . . . . . . . . . . . . . . . . . . . . . . . . . . . . . . . . . . . . . . . . . . . . . . . . . . . . . . . . . . . . . . . . . . 
B B B B B B B B B B B B B B B B B B B B B B B B B B . . . . B B B B B B B B . . . . . . . B B B B B B B B B B B B B B B B B B B B B B B . B B B B B B B B B B B 
B B B B B B B B B B B B B B B B B B B B B B B B B B . . . . B B B B B B B B . . . . . . B B B B B B B B B B B B B B B B B B B B B B B B . B B B B B B B B B B B 
. . . . . . . . . . . . . . . . . . . . . . . . . . . . . . . . . . . . . B . . . . B B B B B B B B B B B B B B B B B B B B B B B B B B . B B B B B B B B B B B 
. . . . . . . . . . . . . . . . . . . . . . . . . . . . . . . . . . . . . B . . . . B . . . . . . . . . . . . . . . . . . . . . . . . . . . . . . . . . . . . . 
. . . . . . . . . . . . . . . . . . . . . . . . . . . . . . . . . . . B B B . . . . B B B . . . . . . . . . . . . . . . . . . . . . . . . . . . . . . . . . . . 
. . . . . . . . . . . . . . . . . . . . . . . . . . . . . . . . . . . B . . . . . . . . . B . . . . . . . . . . . . . . . . . . . . . . . . . . . . . . . . . . 
. . . . . . . . . . . . . . . . . . . . . . . . . . . . . . . . . . . B . . . . . . . . . B . . . . . . . . . . . . . . . . . . . . . . . . . . . . . . . . . . 
. . . . . . . . . . . . . . . . . . . . . . . . . . . . . . . . . . . B . . . . . . . . . B . . . . . . . . . . . . . . . . . . . . . . . . . . . . . . . . . B 
B B B B B B B B B B B B B B B B B B B B B B B B B B B B B B B B B B B B . . . . . . . . . B B B B B B B B B B B B B B B B B B B B B B B B B B B B B B B B B B . 
. . . . . . . . . . . . . . . . . . . . . . . . . . . . . . . . . . . . . . . . . . . . . . . . . . . . . . . . . . . . . . . . . . . . . . . . . . . . . . . . 
. . . . . . . . . . . . . . . . . . . . . . . . . . . . . . . . . . . . . . . . . . . . . . . . . . . . . . . . . . . . . . . . . . . . . . . . . . . . . . . . 
. . . . . . . . . . . . . . . . . . . . . . . . . . . . . . . . . . . . . . . . . . . . . . . . . . . . . . . . . . . . . . . . . . . . . . . . . . . . . . . . 
. . . . . . . . . . . . . . . . . . . . . . . . . . . . . . . . . . . . . . . . . . . . . . . . . . . . . . . . . . . . . . . . . . . . . . . . . . . . . . . . 
. . . . . . . . . . . . . . . . . . . . . . . . . . . . . . . . . . . . . . . . . . . . . . . . . . . . . . . . . . . . . . . . . . . . . . . . . . . . . . . . 
. . . . . . . . . . . . . . . . . . . . . . . . . . . . . . . . . . . . . . . . . . . . . . . . . . . . . . . . . . . . . . . . . . . . . . . . . . . . . . . . 
. . . . . . . . . . . . . . . . . . . . . . . . . . . . . . . . . . . . . . . . . - - - - - . . . . . . . . . . . . . . . . . . . . . . . . . . . . . . . . . . 
. . . . . . . . . . . . . . . . . . . . . . . . . . . . . . . . . . . . . . . . - - 7 8 9 - - . . . . . . . . . . . . . . . . . . . . . . . . . . . . . . . . . 
. . . . . . . . . . . . . . . . . . . . . . . B . . . . . . . . . . . . . . . - - ~ 6 B - 0 - - . . . . . . . . . . . . . . . . . . . . . . . . . . . . . . . . 
. . . . . . . . . . . . . . . . . . . . . . . B . . . . . . . . . . . . . . . - ~ ~ 5 B - - 1 - - - - - - - - - - - - - - - - - - - . . . . . . . . . . . . . . 
. . . . . . . . . . . . . . . . . . . . . . . B . . B B B B B B B B B B B B B B B B 4 B . - - 2 3 4 5 6 7 8 9 0 1 2 3 4 5 6 7 8 9 0 . . . . . . . . . . . . . . 
. . . . . . . . . . . . . . . . . . . . . . . B . B B B B B B B B B B B B B B B B B 3 B . . - - - - - - - - - - - - - - - - - - - - . . . . . . . . . . . . . . 
. . . . . . . . . . . . . . . . . . . . . . . B . . B B B B B B B B B B B B B B B B 2 B . . . . . . . . . . . . . . . . . . . . . . . . . . . . . . . . . . . . 
. . . . . . . . . . . . . . . . . . . . . . . B . . . . . - ~ ~ ~ ~ ~ ~ ~ ~ 7 8 9 0 1 B . . . . . . . . . . . . . . . . . . . . . . . . . . . . . . . . . . . . 
. . . . . . . . . . . . . . . . . . . . . . . B B B B . . - ~ ~ ~ ~ ~ ~ ~ ~ 6 B B B B B . . . . . . . . . . . . . . . . . . . . . . . . . . . . . . . . . . . . 
. . . . . . . . . . . . . . . . . . . . . . . B . . . . . - ~ ~ ~ ~ ~ ~ ~ ~ 5 ~ ~ ~ ~ B . . . . . . . . . . . . . . . . . . . . . . . . . . . . . . . . . . . . 
. . . . . . . . . . . . . . . . . . . . . . . . . . . . . - ~ ~ ~ ~ ~ ~ ~ 4 ~ ~ ~ ~ ~ B . . . . . . . . . . . . . . . . . . . . . . . . . . . . . . . . . . . . 
B . . . . . . . . . . . . . . . . . . . . . . . . . . . . - ~ ~ ~ ~ ~ ~ 3 ~ ~ ~ ~ ~ ~ B . . . . . . . . . . . . . . . . . . . . . . . . . . . . . . . . . . . . 
. B . . . . . . . . . . . . . . . . . . . . . . . . . . . - ~ ~ ~ ~ ~ 2 ~ ~ ~ ~ ~ ~ ~ B . . . . . . . . . . . . . . . . . . . . . . . . . . . . . . . . . . . . 
. . B . . . . . . . . . . . . . . . . . . . . . . . . . . - ~ ~ ~ ~ 1 ~ ~ ~ ~ ~ ~ ~ ~ B B B B B B B B B B B B B B B B B B B B B B B B B B B B B B B B B B B B B 
. . . B . . . . . . . . . . . . . . . . . . . . . . . . . - ~ ~ ~ 0 ~ ~ ~ ~ ~ ~ ~ ~ ~ B B B B B B B B B B B B B B B B B B B B B B B B B B B B B B B B B B B B B 
. . . . B . . . . . . . . . . . . . . . . . . . . . . . . - ~ ~ 9 ~ ~ ~ ~ ~ ~ ~ ~ ~ B B B ~ ~ ~ ~ ~ ~ ~ ~ ~ ~ ~ ~ ~ ~ ~ ~ ~ ~ ~ ~ ~ ~ ~ ~ ~ ~ ~ ~ ~ ~ ~ ~ ~ ~ ~ 
. . . . . B B B B B B B B B B B B B B B B B B . . . . . . - ~ 8 ~ ~ ~ ~ ~ ~ ~ ~ ~ ~ B B B ~ ~ ~ ~ ~ ~ ~ ~ ~ ~ ~ ~ ~ ~ ~ ~ ~ ~ ~ ~ ~ ~ ~ ~ ~ ~ ~ ~ ~ ~ ~ ~ ~ ~ ~ 
. . . . . . . . . . . . . . . . . . . . . . . . . . . . . - 7 ~ B B - ~ ~ ~ ~ ~ ~ ~ ~ B ~ ~ ~ ~ ~ ~ ~ ~ ~ ~ ~ ~ ~ ~ ~ ~ ~ ~ ~ ~ ~ ~ ~ ~ ~ ~ ~ ~ ~ ~ ~ ~ ~ ~ ~ ~ 
. . . . . . . . . . . . . . . . . . . . . . . . . . . . . - 6 B B . - - - - - - - - - B ~ ~ ~ ~ ~ ~ ~ ~ ~ ~ ~ ~ ~ ~ ~ ~ ~ B ~ ~ ~ ~ ~ ~ ~ ~ ~ ~ ~ ~ ~ ~ ~ ~ ~ ~ 
. . . . . . . . . . . . . . . . . . . . . . . . . . . . . - 5 B B . . . . . . . . . . B ~ ~ ~ ~ ~ ~ ~ ~ ~ ~ ~ ~ ~ ~ ~ ~ B B B ~ ~ ~ ~ ~ ~ ~ ~ ~ ~ ~ ~ ~ ~ ~ ~ ~ 
. . . . . . . . . . . . . . . . . . . . . . . . . . . . . - 4 B B . . . . . . . . . . B ~ ~ ~ ~ ~ ~ ~ ~ ~ ~ ~ ~ ~ ~ ~ ~ B B B ~ ~ ~ ~ ~ ~ ~ ~ ~ ~ ~ ~ ~ ~ ~ ~ ~ 
. . . . . . . . . . . . . . . . . . . . . . . . . . . . . - 3 B B . . . . . . . . . . B ~ ~ ~ ~ ~ ~ ~ ~ ~ ~ ~ ~ ~ ~ ~ ~ B B B ~ ~ ~ ~ ~ ~ ~ ~ ~ ~ ~ ~ ~ ~ ~ ~ ~ 
. . . . . . . . . . . . . . . . . . . . . . . . . . . . . - 2 ~ B . . . . . . . . . . B ~ ~ ~ ~ ~ ~ ~ ~ ~ ~ ~ ~ ~ ~ ~ ~ B B B ~ ~ ~ ~ ~ ~ ~ ~ ~ ~ ~ ~ ~ ~ ~ ~ ~ 
. . . . . . . . . . . . . . . . . . . . . . . . . . . . . - ~ 1 B . . . . . . . . . . B ~ ~ ~ ~ ~ ~ ~ ~ ~ ~ ~ ~ ~ ~ ~ ~ ~ B ~ ~ ~ ~ ~ ~ ~ ~ ~ ~ ~ ~ ~ ~ ~ ~ ~ ~ 
. . . . . . . . . . . . . . . . . . . . . . . . . . . . . - ~ 0 B . . . . . . . . . . B ~ ~ ~ ~ ~ ~ ~ ~ ~ ~ ~ ~ ~ ~ ~ ~ ~ ~ ~ ~ ~ ~ ~ ~ ~ ~ ~ ~ ~ ~ ~ ~ ~ ~ ~ ~ 
. . . . . . . . . . . . . . . . . . . . . . . . . . . . . - ~ 9 B . . . . . . . . . . B ~ ~ ~ ~ ~ ~ ~ ~ ~ ~ ~ ~ ~ ~ ~ ~ ~ ~ ~ ~ ~ ~ ~ ~ ~ ~ ~ ~ ~ ~ ~ ~ ~ ~ ~ ~ 
. . . . . . . . . . . . . . . B . . . . . . . . . . . . . - ~ 8 B . . . . . . . . . . B ~ ~ ~ ~ ~ ~ ~ ~ ~ ~ ~ ~ ~ ~ ~ ~ ~ ~ ~ ~ ~ ~ ~ ~ ~ ~ ~ ~ ~ ~ ~ ~ ~ ~ ~ ~ 
. . . . . . . . . . . . . . . . B . . . . . . . . . . . . - ~ 7 B . . . . . . . . . . B ~ ~ ~ ~ ~ ~ ~ ~ ~ ~ ~ ~ ~ ~ ~ ~ ~ ~ ~ ~ ~ ~ ~ ~ ~ ~ ~ ~ ~ ~ ~ ~ ~ ~ ~ ~ 
. . . . . . . . . . . . . . . . . B . . . . . . . . . . . - ~ 6 B . . . . . . . . . . B S ~ ~ ~ ~ ~ ~ ~ ~ ~ ~ ~ ~ ~ ~ ~ ~ ~ ~ ~ ~ B B ~ ~ ~ ~ ~ ~ ~ ~ ~ ~ ~ ~ ~ 
. . . . . . . . . . . . . . . . . . B . . . . . . . . . . - ~ 5 B B B B B B B B B B B B 0 ~ ~ ~ ~ ~ ~ ~ ~ ~ ~ ~ ~ ~ ~ ~ ~ ~ ~ ~ ~ B B ~ ~ ~ ~ ~ ~ ~ ~ ~ ~ ~ ~ ~ 
B B B B B B . . . . . . . . . . . . . B . B . . . . . . . - ~ 4 3 2 1 0 9 8 7 6 5 4 3 2 1 ~ ~ ~ ~ ~ ~ ~ ~ ~ ~ ~ ~ ~ ~ ~ ~ ~ ~ ~ ~ ~ ~ ~ ~ ~ ~ ~ ~ ~ ~ ~ ~ ~ ~ ~ 
. . . B . . . . . . . . . . . . . . . . B . B B . . . . . - - ~ ~ ~ ~ ~ ~ ~ ~ ~ ~ ~ ~ ~ ~ ~ ~ ~ ~ ~ ~ ~ ~ ~ ~ ~ ~ ~ ~ ~ ~ ~ ~ ~ ~ ~ ~ ~ ~ ~ ~ ~ ~ ~ ~ ~ ~ ~ ~ ~ 
. . . B . . . . . . . . . . . . . . . . . . . . . . . . . . - - ~ ~ ~ ~ ~ ~ ~ ~ ~ ~ ~ ~ ~ ~ ~ ~ ~ ~ ~ ~ ~ ~ ~ ~ ~ ~ ~ ~ ~ ~ ~ ~ ~ ~ ~ ~ ~ ~ ~ ~ ~ ~ ~ ~ ~ ~ ~ - 
. . . B . . . . . . . . . . . . . . . . . . . . . . . . . . . - ~ ~ ~ ~ ~ ~ ~ ~ ~ ~ ~ ~ ~ ~ ~ ~ ~ ~ ~ ~ ~ ~ ~ ~ ~ ~ ~ ~ ~ ~ ~ ~ ~ ~ ~ ~ ~ ~ ~ ~ ~ ~ ~ ~ ~ ~ - - 
. . . B . . . . . . . . . . . . . . . . . . . . . . . . . . . - - ~ ~ ~ ~ ~ ~ ~ ~ ~ ~ ~ ~ ~ ~ B ~ ~ ~ ~ ~ ~ ~ ~ ~ ~ ~ ~ ~ ~ ~ ~ ~ ~ ~ ~ ~ ~ ~ ~ ~ ~ ~ ~ ~ ~ - . 
. . . B . . . . . B B . . . . . . . . . . . . . . . . . . . . . - - ~ ~ ~ ~ ~ ~ ~ ~ ~ ~ ~ ~ ~ B ~ ~ ~ ~ ~ ~ ~ ~ ~ ~ ~ ~ ~ ~ ~ ~ ~ ~ ~ ~ ~ ~ ~ ~ ~ ~ ~ ~ ~ - - . 
. . B B B B B B B B B . . . . . . . . . . . . . . . . . . . . . . - ~ ~ ~ ~ ~ ~ ~ ~ ~ ~ ~ ~ ~ ~ B ~ ~ ~ ~ ~ ~ ~ ~ ~ ~ ~ ~ ~ ~ ~ ~ ~ ~ ~ ~ ~ ~ ~ ~ ~ ~ ~ - - . . 
. . B B B B B B B B B . . . . . . . . . . . . . . . . . . . . . . - - ~ ~ ~ ~ ~ ~ ~ ~ ~ ~ ~ ~ ~ ~ B B ~ ~ ~ ~ ~ ~ ~ ~ ~ ~ ~ ~ ~ ~ ~ ~ ~ ~ ~ ~ ~ ~ ~ ~ ~ - . . . 
. . . . . . . . . . . . . . . . . . . . . . . . . . . . . . . . . . - - ~ ~ ~ ~ ~ ~ ~ ~ ~ ~ ~ ~ ~ ~ B B ~ ~ ~ ~ ~ ~ ~ ~ ~ ~ ~ ~ ~ ~ ~ ~ ~ ~ ~ ~ ~ ~ ~ - - . . . 
. . . . . . . . . . . . . . . . . . . . . . . . . . . . . . . . . . . - - ~ ~ ~ ~ ~ ~ ~ ~ ~ ~ ~ ~ ~ ~ B B ~ ~ ~ ~ ~ ~ ~ ~ ~ ~ ~ ~ ~ ~ ~ ~ ~ ~ ~ ~ ~ - - . . . . 
. . . . . . . . . . . . . . . . . . . . . . . . . . . . . . . . . . . . - - ~ ~ ~ ~ ~ ~ ~ ~ ~ ~ ~ ~ ~ ~ B B ~ ~ ~ ~ ~ ~ ~ ~ ~ ~ ~ ~ ~ ~ ~ ~ ~ ~ ~ - - . . . . . 
. . . . . . . . . . . . . . . . . . . . . . . . . . . . . . . . . . . . . - - - ~ ~ ~ ~ ~ ~ ~ ~ ~ ~ ~ ~ ~ ~ B ~ ~ ~ B ~ ~ ~ ~ ~ ~ ~ ~ ~ ~ ~ ~ ~ ~ - . . . . . . 
. . . . . . . . . . . . . . . . . . . . . . . . . . . . . . . . . . . . . . . - - ~ ~ ~ ~ ~ ~ ~ ~ ~ ~ ~ ~ ~ B ~ ~ ~ B ~ ~ ~ ~ ~ ~ ~ ~ ~ ~ ~ ~ ~ - - B . . . . . 
. . . . . . . . . . . . . . . . . . . . . . . . . . . . . . . . . . . . . . . . - - - ~ ~ ~ ~ ~ ~ ~ ~ ~ ~ ~ B ~ ~ ~ B ~ ~ ~ ~ ~ ~ ~ ~ ~ ~ ~ ~ - B B B . . . . . 
. . . . . . . . . . . . . . . . . . . . . . B B . . . . . . . . . . . . . . . . . . - - ~ ~ ~ ~ ~ ~ ~ ~ ~ ~ B ~ ~ ~ B ~ ~ ~ ~ ~ ~ ~ ~ ~ ~ ~ ~ B B . . . . . . . 
. . . . . . . . . . . . . . . . . . . . . . B B . . . . . . . . . . . . . . . . . . . - - - - ~ ~ ~ ~ ~ ~ ~ B ~ ~ ~ B ~ ~ ~ ~ ~ ~ ~ ~ ~ ~ ~ - B . . . . . . . . 
. . . . . . . . . . . . . . . . . . . . . . . . . . . . . . . . . . . . . . . . . . . . . . - - - - ~ ~ ~ ~ B ~ ~ ~ B ~ ~ ~ ~ ~ ~ ~ ~ ~ ~ - - . . . . . . . . . 
. . . . . . . . . . . . . . . . . . . . . . . . . . . . . . . . . . . . . . . . . . . . . . . . . - - - - ~ B ~ ~ ~ B ~ ~ ~ ~ ~ ~ ~ ~ ~ ~ - . . . . . . . . . . 
. . B B B B . . . B B . . . . . . . . . . . . . . . . . . . . . . . . . . . . . . . . . . . . . . . . . - - B - - ~ B - ~ ~ ~ ~ ~ ~ ~ ~ - - . . . . . . . . . . 
. B . . . . B B B . . . . . . . . . . . . . . . . . . . . . . . . . . . . . . . . . . . . . . . . . . . . . B . - - B - - - - ~ ~ ~ ~ - - . . . . . . . . . . . 
. B . . . . . . . . . . . . . . . . . . . . . . . . . . . . . . . . . . . . . . . . . . . . . . . . . . . . B . . . B . . . - - - - - - . . . . . . . . . . . . 
. . . . . . . . . . . . . . . . . . . . . . . . . . . . . . . . . . . . . . . . . . . . . . . . . . . . . . . . . . . . . . . . . . . . . . . . . . . . . . . . 
. . . . . . . . . . . . . . . . . . . . . . . . . . . . . . . . . . . . . . . . . . . . . . . . . . . . . . . . . . . . . . . . . . . . . . . . . . . . . . . . 
. . . . . . . . . . . . . . . . . . . . . . . . . . . . . . . . . . . . . . . . . . . . . . . . . . . . . . . . . . . . . . . . . . . . . . . . . . . . . . . . 
. . . . . . . . . . . . . . . . . . . . . . . . . . . . . . . . . . . . . . . . . . . . . . . . . . . . . . . . . . . . . . . . . . . . . . . . . . . . . . . . 
. . . . . . . . . . . . . . . . . . . . . . . . . . . . . . . . . . . . . . . . . . . . . . . . . . . . . . . . . . . . . . . . . . . . . . . . . . . . . . . . 
. . . . . . . . . . . . . . . . . . . . . . . . . . . . . . . . . . . . . . . . . . . . . . . . . . . . . . . . . . . . . . . . . . . . . . . . . . . . . . . . 
. . . . . . . . . . . . . . . . . . . . . . . . . . . . . . . . . . . . . . . . . . . . . . . . . . . . . . . . . . . . . . . . . . . . . . . . . . . . . . . . 
. . . . . . . . . . . . . . . . . . . . . . . . . . . . . . . . . . . . . . . . . . . . . . . . . . . . . . . . . . . . . . . . . . . . . . . . . . . . . . . . 
