B . B B B B . B B B B B B B . 
B . . . . B . . B B B . . B . 
B B B B . B B . B B B . . B . 
B B B B . . . . B B . . B B . 
B . . . . B B B B B E B B B . 
. . B B B B B B B B 4 B . B . 
B . B . . . B B B B 3 B . B . 
B . . . B . - S 0 1 2 - . B . 
B . B . . . B B B B - B B B . 
. . B B B . B B B B . B . . . 
B . B B B . B B B B . . . B B 
B . B B B . B B B B B B B B B 
B . B B B B B B B B B B B B B 
B . . . . . . . . . B B B B B 
B B B B B B B B B . B B B B B 
