. - - - - - - - - - - - - - . 
- - 4 5 6 7 8 9 0 1 2 3 4 - - 
~ ~ 3 B B ~ ~ ~ ~ ~ B B - 5 E 
~ ~ 2 B B B - - - B B B - - - 
~ ~ 1 ~ B B . . . B B . . . . 
~ ~ 0 ~ ~ ~ B B B . . . . . . 
- S ~ ~ ~ ~ B B B . . . . . . 
B B B B B B B B B . . . . . . 
. . . . . . . B . . . . . . . 
. . . . . . . B . . . . . . . 
. . . . . B B B B B . . . . . 
. . . . . B . . . B . . . . . 
. . . . B B . . . B B . . . . 
. . . . . B . . . B . . . . . 
. . . . . . . . . . . . . . . 
