. . . . . . . . . . . . . . . 
. . . . . . . . . . . . . . . 
. . . B B . . . . . B B . . . 
. . . B B B . . . B B B . . . 
. . . . B B . . . B B . . . . 
. . . . . . B B B . . . . . . 
. . . . . . B B B . . . . . . 
B B B B B B B B B . . . E - - 
. . . . . . . B . . . . - S - 
. . . . . . . B . . . . - - - 
. . . . . B B B B B . . . . . 
. . . . . B . . . B . . . . . 
. . . . B B . . . B B . . . . 
. . . . . B . . . B . . . . . 
. . . . . . . . . . . . . . . 
