- - - ~ ~ ~ ~ ~ ~ ~ ~ ~ - - . 
- ~ 5 6 7 8 9 0 1 2 3 4 5 - . 
~ ~ 4 B B ~ ~ ~ ~ ~ B B 6 - . 
~ ~ 3 B B B ~ ~ ~ B B B 7 - . 
~ ~ 2 ~ B B ~ ~ ~ B B - 8 - . 
~ ~ ~ 1 0 S B B B . - 9 - - . 
~ ~ ~ ~ ~ ~ B B B . - E - . . 
B B B B B B B B B . . . . . . 
. . . . . . . B . . . . . . . 
. . . . . . . B . . . . . . . 
. . . . . B B B B B . . . . . 
. . . . . B . . . B . . . . . 
. . . . B B . . . B B . . . . 
. . . . . B . . . B . . . . . 
. . . . . . . . . . . . . . . 
