B B B B B B B B B . . . . . . . . . . . 
B X ~ ~ B . . . B . . . . . . . . . E B 
B ~ ~ ~ B . . . B . . . . . . B B B B B 
B B B B B B B . B . . . B B B . . . . B 
B . . . . . . . B B . . . . . . . . . B 
B B B . . . B B B . B B . . . . . . . B 
B . . . . . . . . B B B B B B B B B B B 
B . . . . . . . . . . . . . . . . . . B 
B . . . . . . . . B . . . . . . . . . B 
. . . . . . . . . . . B . . . . . . . . 
