. . . . . . . . . . . . . . . 
. . . . . . . . . . . . . - - 
. . . B B . . . . . B B - - S 
. . . B B B . . . B B B - 0 - 
. . . . B B . . . B B . - E - 
. . . . . . B B B . . . . . . 
. . . . . . B B B . . . . . . 
B B B B B B B B B . . . . . . 
. . . . . . . B . . . . . . . 
. . . . . . . B . . . . . . . 
. . . . . B B B B B . . . . . 
. . . . . B . . . B . . . . . 
. . . . B B . . . B B . . . . 
. . . . . B . . . B . . . . . 
. . . . . . . . . . . . . . . 
