B . B B B B . B B B B B B B ~ 
B . . . . B . . B B B - E B ~ 
B B B B . B B . B B B 5 - B ~ 
B B B B . . . . B B 3 4 B B ~ 
B . . . . B B B B B 2 B B B ~ 
. . B B B B B B B B 1 B ~ B ~ 
B . B . . . B B B B 0 B ~ B ~ 
B . . . B . . . . - 9 ~ ~ B S 
B . B . . . B B B B 8 B B B 0 
. . B B B . B B B B 7 B 3 2 1 
B . B B B . B B B B 6 5 4 B B 
B . B B B . B B B B B B B B B 
B . B B B B B B B B B B B B B 
B . . . . . . . . . B B B B B 
B B B B B B B B B . B B B B B 
