. . . - - ~ ~ ~ ~ ~ ~ ~ ~ ~ - 
. . . - ~ ~ ~ ~ ~ ~ ~ ~ ~ ~ ~ 
. . . B B ~ ~ ~ ~ ~ B B ~ ~ ~ 
. . . B B B ~ ~ ~ B B B ~ ~ ~ 
. . . . B B ~ ~ ~ B B ~ ~ ~ ~ 
. . . . . . B B B ~ ~ ~ ~ ~ ~ 
. . . . . . B B B ~ ~ ~ ~ ~ ~ 
B B B B B B B B B ~ ~ ~ S ~ ~ 
. . . - - 8 E B ~ ~ ~ 0 ~ ~ ~ 
. . . - 7 - - B ~ ~ ~ 1 ~ ~ ~ 
. . - - 6 B B B B B ~ 2 ~ ~ ~ 
. . - 5 - B ~ ~ ~ B ~ 3 ~ ~ ~ 
. . - 4 B B ~ ~ ~ B B 4 ~ ~ ~ 
. . - 3 ~ B ~ ~ ~ B ~ 5 ~ ~ ~ 
. . - - 2 1 0 9 8 7 6 ~ ~ ~ ~ 
