B . B B B B . B B B B B B B ~ 
B . . . . B . . B B B . . B ~ 
B B B B . B B . B B B . . B ~ 
B B B B . . . . B B . . B B S 
B . . . . B B B B B . B B B 0 
. . B B B B B B B B - B . B 1 
B E B 1 0 9 B B B B ~ B . B 2 
B 4 3 2 B 8 7 6 5 4 3 ~ - B 3 
B - B ~ ~ ~ B B B B 2 B B B 4 
. . B B B - B B B B 1 B 7 6 5 
B . B B B . B B B B 0 9 8 B B 
B . B B B . B B B B B B B B B 
B . B B B B B B B B B B B B B 
B . . . . . . . . . B B B B B 
B B B B B B B B B . B B B B B 
