. . . . . . . . - - - - - - . 
. . . . . . . - - 5 4 3 2 - - 
. . . B B . . - 6 - B B 1 ~ - 
. . . B B B . - E B B B 0 ~ ~ 
. . . . B B . . . B B ~ 9 ~ ~ 
. . . . . . B B B ~ ~ 8 ~ ~ ~ 
. . . . . . B B B ~ ~ 7 ~ ~ ~ 
B B B B B B B B B ~ ~ 6 ~ ~ ~ 
~ ~ ~ ~ ~ ~ ~ B ~ ~ ~ 5 ~ ~ ~ 
~ ~ ~ ~ ~ ~ ~ B ~ ~ ~ 4 ~ ~ ~ 
~ ~ ~ ~ ~ B B B B B ~ 3 ~ ~ ~ 
S 0 ~ ~ ~ B ~ ~ ~ B ~ 2 ~ ~ ~ 
~ ~ 1 ~ B B ~ ~ ~ B B 1 ~ ~ ~ 
~ ~ ~ 2 ~ B ~ ~ ~ B ~ 0 ~ ~ - 
~ ~ ~ ~ 3 4 5 6 7 8 9 ~ ~ ~ - 
