. . . . . . . . . . . . . . . 
. . . . . . . . . . . . . . . 
. . . B B . . . . . B B . . . 
. . . B B B . . . B B B . . . 
. . . . B B . . . B B . . . . 
. . . . . . B B B . . . . . . 
. . . . . . B B B E - . . . . 
B B B B B B B B B 6 - . . . . 
~ ~ ~ ~ ~ ~ ~ B - 5 - - . . . 
~ ~ ~ ~ ~ ~ ~ B - - 4 - . . . 
~ ~ S ~ ~ B B B B B 3 - - . . 
~ ~ ~ 0 ~ B ~ ~ ~ B - 2 - . . 
~ ~ ~ 1 B B ~ ~ ~ B B 1 - . . 
~ ~ ~ 2 ~ B ~ ~ ~ B ~ 0 - . . 
- ~ ~ ~ 3 4 5 6 7 8 9 - - . . 
