. - - ~ ~ ~ ~ ~ ~ ~ ~ ~ ~ ~ ~ 
. - 3 2 1 0 9 8 7 6 5 4 3 ~ ~ 
. - 4 B B ~ ~ ~ ~ ~ B B 2 ~ ~ 
. - 5 B B B ~ ~ ~ B B B 1 ~ ~ 
. - 6 - B B ~ ~ ~ B B ~ 0 ~ ~ 
. - - 7 8 E B B B ~ ~ 9 ~ ~ ~ 
. . - - - - B B B ~ ~ 8 ~ ~ ~ 
B B B B B B B B B ~ ~ 7 ~ ~ ~ 
~ ~ ~ ~ ~ ~ ~ B ~ ~ ~ 6 ~ ~ ~ 
~ S ~ ~ ~ ~ ~ B ~ ~ ~ 5 ~ ~ ~ 
~ ~ 0 ~ ~ B B B B B ~ 4 ~ ~ ~ 
~ ~ ~ 1 ~ B ~ ~ ~ B ~ 3 ~ ~ ~ 
~ ~ ~ 2 B B ~ ~ ~ B B 2 ~ ~ ~ 
~ ~ ~ 3 ~ B ~ ~ ~ B ~ 1 ~ ~ ~ 
~ ~ ~ ~ 4 5 6 7 8 9 0 ~ ~ ~ ~ 
