B B B B B B B B B B B B B B B B B B B B 
B . . . B . . . B . . . . . . . . . . B 
B . . . B . . . B . . . . . . B B B B B 
B B B B B B B . B . . . . B B . . . . B 
B . . . . . . . B B . . B . - - - . . B 
B B B B B B B B B . B B . . E S - . . B 
B . . . . . . . . B B B B B B B B B B B 
B . . . . . . . . . . . . . . . . . . B 
B . . . . . . . . . . . . . . . . . . B 
B B B B B B B B B B B B B B B B B B B B 
