. . . - - ~ ~ ~ ~ ~ ~ ~ ~ - - 
. . . - ~ ~ ~ ~ ~ ~ ~ ~ ~ ~ - 
. . . B B ~ ~ ~ ~ ~ B B ~ ~ ~ 
. . . B B B ~ ~ ~ B B B ~ ~ ~ 
. . . . B B ~ ~ ~ B B ~ ~ ~ ~ 
. . . . . . B B B ~ ~ ~ ~ ~ ~ 
. . . . . . B B B S ~ ~ ~ ~ ~ 
B B B B B B B B B 0 ~ ~ ~ ~ ~ 
. . . - - E . B ~ 1 ~ ~ ~ ~ ~ 
. . . - 8 - . B ~ ~ 2 ~ ~ ~ ~ 
. . - - 7 B B B B B 3 ~ ~ ~ ~ 
. . - 6 - B ~ ~ ~ B ~ 4 ~ ~ ~ 
. . - 5 B B ~ ~ ~ B B 5 ~ ~ ~ 
. . - 4 ~ B ~ ~ ~ B ~ 6 ~ ~ ~ 
. . - - 3 2 1 0 9 8 7 ~ ~ ~ - 
