B . B B B B . B B B B B B B . 
B . . . . B . . B B B S - B . 
B B B B . B B . B B B 0 - B . 
B B B B . . . . B B 2 1 B B . 
B . . . . B B B B B 3 B B B . 
. . B B B B B B B B 4 B . B . 
B . B . . . B B B B 5 B . B . 
B . . . B . . E 8 7 6 - . B . 
B . B . . . B B B B - B B B . 
. . B B B . B B B B . B . . . 
B . B B B . B B B B . . . B B 
B . B B B . B B B B B B B B B 
B . B B B B B B B B B B B B B 
B . . . . . . . . . B B B B B 
B B B B B B B B B . B B B B B 
