. . . . . . . . . . . . . . . 
. . . . . . . . . . . . . . . 
. . . B B . . . . . B B . . . 
. . . B B B . . . B B B . . . 
. . . . B B . . . B B . . . . 
. . . . . . B B B . . . . . . 
. . . . . . B B B . . . . . . 
B B B B B B B B B . . . . . . 
. . . . . . . B . . . . . . . 
. - - - . . . B . . . . . . . 
- - S - . B B B B B . . . . . 
E 0 - - . B . . . B . . . . . 
- - - . B B . . . B B . . . . 
. . . . . B . . . B . . . . . 
. . . . . . . . . . . . . . . 
